 1111
 1001
110011
100101
101001
1100N1
11100111
 1000000
 1111111
