 1111
 1000
110011
100101
101001
1100N1
110011
 1001 
 1111
